########
#S     #
# ### ##
# #   E#
# ##### 
########
